Level 1
W,-,-,X,-
W,-,-,-,-
W,-,W,-,-
W,-,W,-,-
W,E,W,-,-

Level 2
X,-,W,-,-
-,-,W,-,-
W,-,W,-,-
W,-,W,-,-
-,-,-,E,-

Level 3
X,-,-,-,-
-,W,W,W,W
-,-,-,-,-
W,W,W,-,-
E,-,-,-,-